■■■■■■■■■■■■■■■■■■■■■
■                   ■
■                   ■
■                   ■
■                   ■
■         E         ■
■                   ■
■                   ■
■                   ■
■                   ■
■                   ■
■                   ■
■               F   ■
■                   ■
■                   ■
■                   ■
■                   ■
■                   ■
■                   ■
■                   ■
■                   ■
■                   ■
■                   ■
■                   ■
■         P         ■
■                   ■
■                   ■
■■■■■■■■■■■■■■■■■■■■■